NO ./path_to_the_north_texture
SO ./path_to_the_south_texture
WE ./path_to_the_west_texture
EA ./path_to_the_east_texture

F 0,100,155
C 225,0,100

111111111111111111111111111111111
111111111000000000110000000000001
        1011000001110000000000001
        1001000000000000000000001
111111111011000001110000000000001
100000000011000001110111111111111
11110111111111011100000010001
11110111111111011101010010001
11000000110100111100000010001
100000000000000001100000010001
10000000000000001101010010001
11000001110101011111011110W0111
11110111 1110101 1011110100011
111111111 1111111 111111111111
