11111111
100000E1
1C10C111
101C00N1
10101101
1P0C00C1
11111111
