11111111
1     E1
1C11C111
1 1C   1
1 1 11 1
1P C  C1
11111111

