111111111
1P  C  E1
111111111

