11111111
100000E1
1C10C111
101000N1
10100101
1P0C00C1
11111111
